##############
##############
##############
#............#
x............x
##############
#............#
#............#
#######x######
