
##############
#.........#..#
#.........#..#
#...#..#..#..#
#...#..#..#..*
#...#..#..#..#
#............#
#............#
##############

