#######x######
#..#......#..#
#............#
#............#
x....#..#....x
#............#
#............#
#..k..@......#
##############

