#######x######
#........#...#
#........#...#
#........#...#
x........#...#
#.......#....#
########.....#
#............#
##############

