##############
#.....#......#
#............#
#..#.....#...#
*..#..#..#...#
#..#.....#...#
#............#
#.....#......#
##############

