##############
#............#
#............#
#..#......#..#
x..#....,.#..x
#..#......#..#
#..#......#..#
#..#......#..#
#######*######

