#######x######
#..#....#....#
#..#....#....#
#..#....#....#
#..#....#..#.x
#..#....#..#.#
#..#.......#.#
#..#.......#.#
##############

