#######x######
#...#........#
#...#........#
#...#........#
#...#........*
#...#........#
#....#########
#............#
##############

