##############
#............#
#....#########
#...#........#
#...#........x
#...#........#
#...#........#
#...#........#
#######*######


