##############
#.#.......#..#
#.#.......#..#
#.#..#....#..#
x.#..#....#..x
#....#....#..#
#....#....#..#
#....#....#..#
#######x######

