
##############
#............#
#............#
#.#..#..#..#.#
*.#..#..#..#.#
#.#..#..#..#.#
#............#
#............#
##############

