
#######x######
#.#........#.#
#.#........#.#
#............#
x............*
#............#
#.#........#.#
#.#........#.#
##############

